1,2,201,20109,ALAJUELA,ALAJUELA,RIO SEGUNDO,Río Segundo       ,8382,4716,4539,177,153,24,3666,576,37,737,1787,529
2,2,201,20108,ALAJUELA,ALAJUELA,SAN RAFAEL,San Rafael        ,20137,11372,10814,558,493,65,8765,765,99,2272,3414,2215
3,2,209,20903,ALAJUELA,OROTINA,HACIENDA VIEJA,Hacienda Vieja    ,813,422,413,9,8,1,391,66,1,91,148,85
4,2,204,20401,ALAJUELA,SAN MATEO,SAN MATEO,San Mateo         ,2103,991,973,18,17,1,1112,112,8,237,463,292
5,2,204,20402,ALAJUELA,SAN MATEO,DESMONTE,Desmonte          ,812,342,338,4,2,2,470,15,2,81,227,145
6,2,201,20105,ALAJUELA,ALAJUELA,GUACIMA,Guácima           ,14959,8337,8093,244,224,20,6622,608,23,1483,3448,1060
7,2,201,20104,ALAJUELA,ALAJUELA,SAN ANTONIO,San Antonio       ,19002,10875,10462,413,361,52,8127,972,42,1937,4094,1082
8,2,201,20102,ALAJUELA,ALAJUELA,SAN JOSE,San José          ,32052,18164,17529,635,554,81,13888,1737,94,3488,6375,2194
9,2,201,20111,ALAJUELA,ALAJUELA,TURRUCARES,Turrúcares        ,5772,3039,2968,71,61,10,2733,381,7,625,1339,381
10,2,203,20305,ALAJUELA,GRECIA,TACARES,Tacares           ,6013,3269,3182,87,78,9,2744,291,4,625,1499,325
11,2,205,20504,ALAJUELA,ATENAS,SAN ISIDRO,San Isidro        ,2155,1045,1028,17,10,7,1110,53,3,214,535,305
12,2,205,20506,ALAJUELA,ATENAS,SAN JOSE,San José          ,1499,758,741,17,12,5,741,75,18,169,356,123
13,2,205,20503,ALAJUELA,ATENAS,MERCEDES,Mercedes          ,2427,1245,1214,31,22,9,1182,187,16,284,566,129
14,2,205,20502,ALAJUELA,ATENAS,JESUS,Jesús            ,2834,1476,1439,37,33,4,1358,226,11,299,697,125
15,2,205,20508,ALAJUELA,ATENAS,ESCOBAL,Escobal,658,272,264,8,7,1,386,70,3,53,201,59
16,2,205,20505,ALAJUELA,ATENAS,CONCEPCION,Concepción        ,2732,1302,1283,19,17,2,1430,261,2,352,630,185
17,2,205,20501,ALAJUELA,ATENAS,ATENAS,Atenas            ,6113,3203,3132,71,59,12,2910,559,28,903,1110,310
18,2,203,20307,ALAJUELA,GRECIA,PUENTE DE PIEDRA,Puente de Piedra  ,7920,4167,4017,150,131,19,3753,488,7,909,1814,535
19,2,201,20113,ALAJUELA,ALAJUELA,LA GARITA,Garita          ,5619,3108,3018,90,75,15,2511,350,12,623,1179,347
20,2,205,20507,ALAJUELA,ATENAS,SANTA EULALIA,Santa Eulalia     ,1588,850,834,16,15,1,738,78,3,180,377,100
21,2,207,20702,ALAJUELA,PALMARES,ZARAGOZA,Zaragoza          ,6444,3305,3199,106,91,15,3139,361,4,927,1401,446
22,2,207,20704,ALAJUELA,PALMARES,SANTIAGO,Santiago          ,2145,1048,1022,26,19,7,1097,83,3,315,524,172
23,2,207,20707,ALAJUELA,PALMARES,GRANJA,La Granja         ,3184,1613,1557,56,51,5,1571,242,5,408,683,233
24,2,207,20703,ALAJUELA,PALMARES,BUENOS AIRES,Buenos Aires      ,5897,3153,3061,92,78,14,2744,393,12,765,1141,433
25,2,202,20201,ALAJUELA,SAN RAMON,SAN RAMON,San Ramón         ,7220,3680,3588,92,82,10,3540,895,50,1092,1060,443
26,2,202,20204,ALAJUELA,SAN RAMON,PIEDADES NORTE,Piedades Norte    ,6213,3097,3026,71,63,8,3116,323,11,936,1365,481
27,2,202,20203,ALAJUELA,SAN RAMON,SAN JUAN,San Juan          ,8957,4559,4386,173,152,21,4398,672,19,1280,1657,770
28,2,202,20209,ALAJUELA,SAN RAMON,ALFARO,Alfaro            ,5472,2790,2719,71,59,12,2682,287,14,921,1054,406
29,2,202,20207,ALAJUELA,SAN RAMON,SAN ISIDRO,San Isidro        ,3388,1722,1697,25,21,4,1666,129,2,444,689,402
30,2,202,20211,ALAJUELA,SAN RAMON,CONCEPCION,Concepción        ,1787,838,809,29,26,3,949,50,0,230,545,124
31,2,202,20210,ALAJUELA,SAN RAMON,VOLIO,Volio            ,1731,930,895,35,26,9,801,91,0,221,381,108
32,2,207,20705,ALAJUELA,PALMARES,CANDELARIA,Candelaria        ,1509,788,751,37,36,1,721,52,1,179,401,88
33,2,206,20607,ALAJUELA,NARANJO,ROSARIO,El Rosario        ,2716,1402,1372,30,26,4,1314,95,3,267,741,208
34,2,207,20701,ALAJUELA,PALMARES,PALMARES,Palmares          ,2986,1509,1472,37,31,6,1477,259,11,373,571,263
35,2,206,20602,ALAJUELA,NARANJO,SAN MIGUEL,San Miguel        ,3375,1763,1729,34,33,1,1612,102,10,411,814,275
36,2,207,20706,ALAJUELA,PALMARES,ESQUIPULAS,Esquipulas        ,4867,2573,2485,88,72,16,2294,238,4,646,1125,281
37,2,206,20601,ALAJUELA,NARANJO,NARANJO,Naranjo           ,12353,6287,6100,187,162,25,6066,780,34,1683,2785,784
38,2,206,20603,ALAJUELA,NARANJO,SAN JOSE,San José          ,2415,1193,1167,26,22,4,1222,92,0,300,699,131
39,2,206,20606,ALAJUELA,NARANJO,SAN JUAN,San Juan          ,2356,1258,1212,46,42,4,1098,132,2,317,540,107
40,2,203,20304,ALAJUELA,GRECIA,SAN ROQUE,San Roque         ,8512,4541,4431,110,82,28,3971,453,18,1022,1917,561
41,2,212,21201,ALAJUELA,VALVERDE VEGA,SARCHI NORTE,Sarchí Norte      ,5406,2735,2671,64,62,2,2671,293,9,625,1321,423
42,2,212,21202,ALAJUELA,VALVERDE VEGA,SARCHI SUR,Sarchí Sur        ,3915,2040,1967,73,63,10,1875,181,6,480,1021,187
43,2,206,20604,ALAJUELA,NARANJO,CIRRI SUR,Cirrí Sur         ,3430,1747,1712,35,27,8,1683,112,5,402,955,209
44,2,208,20804,ALAJUELA,POAS,CARRILLOS,Carrillos         ,6808,3598,3466,132,117,15,3210,300,11,742,1748,409
45,2,201,20112,ALAJUELA,ALAJUELA,TAMBOR,Tambor            ,8180,4373,4254,119,97,22,3807,429,9,836,2082,451
46,2,203,20303,ALAJUELA,GRECIA,SAN JOSE,San José          ,6064,3257,3183,74,61,13,2807,223,14,744,1450,376
47,2,203,20301,ALAJUELA,GRECIA,GRECIA,Grecia            ,12069,6677,6494,183,153,30,5392,1219,26,1442,2105,600
48,2,212,21204,ALAJUELA,VALVERDE VEGA,SAN PEDRO,San Pedro         ,2554,1237,1206,31,28,3,1317,140,1,309,727,140
49,2,203,20308,ALAJUELA,GRECIA,BOLIVAR,Bolívar           ,5492,2871,2770,101,84,17,2621,234,5,608,1396,378
50,2,203,20302,ALAJUELA,GRECIA,SAN ISIDRO,San Isidro        ,4591,2439,2364,75,65,10,2152,282,10,540,1111,209
51,2,206,20605,ALAJUELA,NARANJO,SAN JERONIMO,San Jerónimo      ,2388,1173,1127,46,43,3,1215,79,3,318,629,186
52,2,201,20107,ALAJUELA,ALAJUELA,SABANILLA,Sabanilla         ,6557,3494,3393,101,82,19,3063,230,10,686,1679,458
53,2,208,20803,ALAJUELA,POAS,SAN RAFAEL,San Rafael        ,4104,2213,2136,77,61,16,1891,181,5,471,1023,211
54,2,208,20801,ALAJUELA,POAS,SAN PEDRO,San Pedro         ,5851,3116,2993,123,103,20,2735,409,14,669,1355,288
55,2,212,21205,ALAJUELA,VALVERDE VEGA,RODRIGUEZ,Rodríguez         ,1561,787,746,41,35,6,774,70,1,196,381,126
56,2,208,20802,ALAJUELA,POAS,SAN JUAN,San Juan          ,3499,1863,1811,52,45,7,1636,168,3,349,816,300
57,2,201,20110,ALAJUELA,ALAJUELA,DESAMPARADOS,Desamparados      ,19768,11296,10878,418,369,49,8472,1040,53,2197,3821,1361
58,2,201,20106,ALAJUELA,ALAJUELA,SAN ISIDRO,San Isidro        ,12938,7106,6815,291,260,31,5832,591,29,1383,2807,1022
59,2,201,20101,ALAJUELA,ALAJUELA,ALAJUELA,Alajuela          ,34485,18996,18407,589,510,79,15489,3312,213,3584,5890,2490
60,2,201,20103,ALAJUELA,ALAJUELA,CARRIZAL,Carrizal          ,5077,2896,2787,109,86,23,2181,210,9,558,1133,271
61,2,213,21306,ALAJUELA,UPALA,DOS RIOS,Dos Ríos          ,2095,830,801,29,24,5,1265,62,2,314,680,207
62,2,213,21303,ALAJUELA,UPALA,SAN JOSE,San José o Pizote ,4944,2020,1986,34,25,9,2924,125,8,674,1375,742
63,2,213,21305,ALAJUELA,UPALA,DELICIAS,Delicias          ,2993,1293,1277,16,13,3,1700,74,4,398,941,283
64,2,214,21402,ALAJUELA,LOS CHILES,CAÑO NEGRO,Caño Negro        ,1299,557,555,2,2,0,742,37,3,158,374,170
65,2,214,21401,ALAJUELA,LOS CHILES,LOS CHILES,Los Chiles        ,8858,4311,4101,210,191,19,4547,186,13,1063,2466,819
66,2,213,21302,ALAJUELA,UPALA,AGUAS CLARAS,Aguas Claras      ,3497,1540,1487,53,44,9,1957,84,6,368,1056,443
67,2,213,21301,ALAJUELA,UPALA,UPALA,Upala            ,11221,5498,5341,157,138,19,5723,378,43,1351,2765,1186
68,2,213,21307,ALAJUELA,UPALA,YOLILLAL,Yolillal          ,2246,890,866,24,22,2,1356,53,2,261,705,335
69,2,214,21403,ALAJUELA,LOS CHILES,EL AMPARO,El Amparo         ,4133,1949,1903,46,38,8,2184,99,10,439,1251,385
70,2,213,21304,ALAJUELA,UPALA,BIJAGUA,Bijagua           ,3308,1542,1514,28,25,3,1766,175,8,331,995,257
71,2,215,21503,ALAJUELA,GUATUSO,COTE,Cote             ,646,263,257,6,6,0,383,22,1,44,208,108
72,2,215,21501,ALAJUELA,GUATUSO,SAN RAFAEL,San Rafael        ,5550,2599,2498,101,86,15,2951,174,14,600,1466,697
73,2,214,21404,ALAJUELA,LOS CHILES,SAN JORGE,San Jorge         ,1905,873,836,37,34,3,1032,63,4,206,576,183
74,2,210,21013,ALAJUELA,SAN CARLOS,POCOSOL,Pocosol           ,10471,4929,4780,149,132,17,5542,305,15,1327,3030,865
75,2,210,21006,ALAJUELA,SAN CARLOS,PITAL,Pital            ,12124,6823,6650,173,124,49,5301,283,39,1158,3106,715
76,2,210,21010,ALAJUELA,SAN CARLOS,VENADO,Venado            ,1266,696,676,20,19,1,570,44,2,112,366,46
77,2,210,21007,ALAJUELA,SAN CARLOS,FORTUNA,La Fortuna        ,10769,6712,6545,167,145,22,4057,287,51,1046,2183,490
78,2,210,21012,ALAJUELA,SAN CARLOS,MONTERREY,Monterrey         ,2482,1318,1291,27,25,2,1164,75,11,269,676,133
79,2,210,21004,ALAJUELA,SAN CARLOS,AGUAS ZARCAS,Aguas Zarcas      ,14116,7575,7319,256,229,27,6541,435,31,1515,3607,953
80,2,210,21011,ALAJUELA,SAN CARLOS,CUTRIS,Cutris            ,6974,3564,3423,141,118,23,3410,155,14,677,1905,659
81,2,203,20306,ALAJUELA,GRECIA,RIO CUARTO,Río Cuarto        ,7521,4062,3947,115,92,23,3459,204,17,751,2078,409
82,2,202,20213,ALAJUELA,SAN RAMON,PEÑAS BLANCAS,Peñas Blancas ,6396,3472,3359,113,94,19,2924,208,17,651,1669,379
83,2,209,20901,ALAJUELA,OROTINA,OROTINA,Orotina           ,7409,3775,3687,88,72,16,3634,570,26,925,1486,627
84,2,209,20902,ALAJUELA,OROTINA,MASTATE,El Mastate        ,1346,635,612,23,21,2,711,54,4,149,303,201
85,2,209,20904,ALAJUELA,OROTINA,COYOLAR,Coyolar           ,4188,1866,1804,62,54,8,2322,222,6,452,1015,627
86,2,209,20905,ALAJUELA,OROTINA,CEIBA,La Ceiba          ,1381,600,582,18,14,4,781,92,0,124,373,192
87,2,204,20403,ALAJUELA,SAN MATEO,JESUS MARIA,Jesús María       ,1804,778,753,25,23,2,1026,120,6,192,515,193
88,2,202,20202,ALAJUELA,SAN RAMON,SANTIAGO,Santiago          ,3340,1765,1712,53,47,6,1575,121,12,455,795,192
89,2,202,20205,ALAJUELA,SAN RAMON,PIEDADES SUR,Piedades Sur      ,2844,1372,1352,20,17,3,1472,90,1,386,820,175
90,2,202,20212,ALAJUELA,SAN RAMON,ZAPOTAL,Zapotal           ,300,172,171,1,1,0,128,11,0,28,83,6
91,2,210,21008,ALAJUELA,SAN CARLOS,TIGRA,La Tigra          ,4540,2217,2166,51,42,9,2323,160,10,488,1207,458
92,2,211,21106,ALAJUELA,ZARCERO,ZAPOTE,Zapote            ,535,293,290,3,3,0,242,13,3,54,125,47
93,2,211,21102,ALAJUELA,ZARCERO,LAGUNA,Laguna            ,1287,750,741,9,5,4,537,35,2,171,290,39
94,2,210,21003,ALAJUELA,SAN CARLOS,BUENAVISTA,Buenavista        ,222,117,116,1,1,0,105,10,0,13,71,11
95,2,210,21002,ALAJUELA,SAN CARLOS,FLORENCIA,Florencia         ,11116,5665,5532,133,124,9,5451,518,18,1286,2841,788
96,2,202,20208,ALAJUELA,SAN RAMON,ANGELES,Ángeles           ,6180,3053,2933,120,110,10,3127,298,14,713,1608,494
97,2,211,21104,ALAJUELA,ZARCERO,GUADALUPE,Guadalupe         ,853,452,444,8,7,1,401,29,0,86,240,46
98,2,211,21103,ALAJUELA,ZARCERO,TAPEZCO,Tapesco           ,952,567,562,5,3,2,385,28,2,101,228,26
99,2,211,21101,ALAJUELA,ZARCERO,ZARCERO,Zarcero           ,3151,1598,1588,10,7,3,1553,203,14,481,730,125
100,2,211,21107,ALAJUELA,ZARCERO,BRISAS,Brisas          ,1474,819,812,7,6,1,655,29,2,184,408,32
101,2,210,21001,ALAJUELA,SAN CARLOS,QUESADA,Quesada           ,31319,17852,17411,441,373,68,13467,1563,102,3992,6058,1752
102,2,210,21009,ALAJUELA,SAN CARLOS,PALMERA,La Palmera        ,4663,2225,2149,76,64,12,2438,210,17,590,1086,535
103,2,211,21105,ALAJUELA,ZARCERO,PALMIRA,Palmira           ,997,591,587,4,4,0,406,22,0,97,278,9
104,2,210,21005,ALAJUELA,SAN CARLOS,VENECIA,Venecia           ,6754,3588,3474,114,88,26,3166,200,39,783,1802,342
105,2,212,21203,ALAJUELA,VALVERDE VEGA,TORO AMARILLO,Toro Amarillo     ,209,128,123,5,4,1,81,7,1,15,47,11
106,2,201,20114,ALAJUELA,ALAJUELA,SARAPIQUI,Sarapiquí         ,2075,1074,1062,12,12,0,1001,64,7,249,551,130
107,2,208,20805,ALAJUELA,POAS,SABANA REDONDA,Sabana Redonda    ,1664,863,830,33,29,4,801,64,0,136,401,200
108,2,202,20206,ALAJUELA,SAN RAMON,SAN RAFAEL,San Rafael        ,7256,3732,3619,113,93,20,3524,428,7,1098,1497,494
109,2,206,20608,ALAJUELA,NARANJO,PALMITOS,Palmitos,3269,1568,1522,46,40,6,1701,174,2,471,837,217
110,2,215,21502,ALAJUELA,GUATUSO,BUENAVISTA,Buenavista        ,1136,474,467,7,6,1,662,36,4,101,372,149
111,2,215,21504,ALAJUELA,GUATUSO,KATIRA,Katira,3640,1725,1692,33,30,3,1915,103,11,364,1147,290
112,3,308,30804,CARTAGO,GUARCO,PATIO DE AGUA,Patio de Agua     ,314,174,159,15,15,0,140,2,0,52,70,16
113,3,302,30203,CARTAGO,PARAISO,OROSI,Orosi            ,6861,3242,3146,96,88,8,3619,322,9,907,1901,480
114,3,304,30403,CARTAGO,JIMENEZ,PEJIBAYE,Pejibaye          ,2486,1093,1063,30,24,6,1393,136,5,369,699,184
115,3,305,30502,CARTAGO,TURRIALBA,LA SUIZA,La Suiza          ,5833,2646,2534,112,103,9,3187,431,5,714,1533,504
116,3,305,30507,CARTAGO,TURRIALBA,TUIS,Tuis             ,2156,937,907,30,26,4,1219,155,3,245,659,157
117,3,305,30508,CARTAGO,TURRIALBA,TAYUTIC,Tayutic           ,1728,772,754,18,13,5,956,120,0,224,522,90
118,3,305,30512,CARTAGO,TURRIALBA,CHIRRIPO,Chirripó,2298,904,867,37,32,5,1394,65,2,404,606,317
119,3,303,30308,CARTAGO,LA UNION,RIO AZUL,Río Azul          ,8447,4720,4547,173,146,27,3727,344,29,818,1712,824
120,3,308,30803,CARTAGO,GUARCO,TOBOSI,Tobosi            ,4780,2504,2427,77,70,7,2276,161,6,576,1189,344
121,3,303,30303,CARTAGO,LA UNION,SAN JUAN,San Juan          ,10699,7042,6854,188,167,21,3657,477,30,1439,1231,480
122,3,303,30302,CARTAGO,LA UNION,SAN DIEGO,San Diego         ,16258,9822,9437,385,344,41,6436,736,28,1966,2658,1048
123,3,303,30304,CARTAGO,LA UNION,SAN RAFAEL,San Rafael        ,10598,6152,5924,228,205,23,4446,556,24,1200,2078,588
124,3,303,30301,CARTAGO,LA UNION,TRES RIOS,Tres Ríos         ,7778,4343,4227,116,103,13,3435,785,29,914,1373,334
125,3,308,30801,CARTAGO,EL GUARCO,TEJAR,El Tejar          ,18976,10776,10432,344,289,55,8200,917,16,2356,3763,1148
126,3,301,30105,CARTAGO,CARTAGO,AGUACALIENTE,Aguacaliente o San Francisco,23815,13001,12467,534,468,66,10814,1000,28,3401,5058,1327
127,3,301,30109,CARTAGO,CARTAGO,DULCE NOMBRE,Dulce Nombre      ,7958,4501,4371,130,112,18,3457,368,13,992,1493,591
128,3,302,30205,CARTAGO,PARAISO,LLANOS DE SANTA LUCIA,Llanos de Santa Lucía,12215,6384,6094,290,246,44,5831,398,10,1522,3085,816
129,3,301,30106,CARTAGO,CARTAGO,GUADALUPE,Guadalupe o Arenilla,11259,6018,5824,194,171,23,5241,608,16,1514,2473,630
130,3,301,30102,CARTAGO,CARTAGO,OCCIDENTAL,Occidental        ,8363,4350,4238,112,95,17,4013,931,30,1214,1355,483
131,3,301,30101,CARTAGO,CARTAGO,ORIENTAL,Oriental          ,10401,5133,4973,160,142,18,5268,1145,34,1791,1644,654
132,3,301,30103,CARTAGO,CARTAGO,CARMEN,Carmen          ,13726,7376,7152,224,183,41,6350,907,13,1704,2729,997
133,3,307,30701,CARTAGO,OREAMUNO,SAN RAFAEL,San Rafael        ,20892,11360,10965,395,343,52,9532,1187,28,2893,4326,1098
134,3,302,30201,CARTAGO,PARAISO,PARAISO,Paraíso           ,16085,8584,8279,305,264,41,7501,1129,20,2094,3396,862
135,3,306,30602,CARTAGO,ALVARADO,CERVANTES,Cervantes         ,4609,2438,2396,42,31,11,2171,240,2,492,1241,196
136,3,302,30204,CARTAGO,PARAISO,CACHI,Cachí            ,4145,1999,1925,74,67,7,2146,247,4,513,1162,220
137,3,304,30402,CARTAGO,JIMENEZ,TUCURRIQUE,Tucurrique        ,3549,1577,1522,55,45,10,1972,234,2,492,1013,231
138,3,306,30603,CARTAGO,ALVARADO,CAPELLADES,Capellades        ,1860,1000,990,10,8,2,860,93,0,135,496,136
139,3,304,30401,CARTAGO,JIMENEZ,JUAN VIÑAS,Juan Viñas        ,5138,2587,2527,60,40,20,2551,427,10,628,1189,297
140,3,301,30104,CARTAGO,CARTAGO,SAN NICOLAS,San Nicolás       ,19353,10261,9874,387,327,60,9092,1063,22,2378,4340,1289
141,3,301,30108,CARTAGO,CARTAGO,TIERRA BLANCA,Tierra Blanca     ,3794,1950,1927,23,20,3,1844,135,1,441,1153,114
142,3,307,30703,CARTAGO,OREAMUNO,POTRERO CERRADO,Potrero Cerrado   ,1672,868,861,7,5,2,804,64,0,158,555,27
143,3,307,30702,CARTAGO,OREAMUNO,COT,Cot             ,6853,3539,3459,80,67,13,3314,257,3,870,1888,296
144,3,307,30705,CARTAGO,OREAMUNO,SANTA ROSA,Santa Rosa        ,1959,1091,1086,5,3,2,868,79,1,179,543,66
145,3,307,30704,CARTAGO,OREAMUNO,CIPRESES,Cipreses          ,2734,1530,1507,23,20,3,1204,90,1,284,770,59
146,3,302,30202,CARTAGO,PARAISO,SANTIAGO,Santiago          ,4012,2086,2031,55,42,13,1926,173,5,399,1092,257
147,3,306,30601,CARTAGO,ALVARADO,PACAYAS,Pacayas           ,4227,2235,2201,34,31,3,1992,167,3,357,1269,196
148,3,303,30306,CARTAGO,LA UNION,DULCE NOMBRE,Dulce Nombre      ,5664,3224,3100,124,99,25,2440,274,6,618,1132,410
149,3,301,30110,CARTAGO,CARTAGO,LLANO GRANDE,Llano Grande      ,3219,1856,1833,23,20,3,1363,115,1,241,849,157
150,3,303,30307,CARTAGO,LA UNION,SAN RAMON,San Ramón         ,3209,1847,1815,32,29,3,1362,156,22,334,418,432
151,3,303,30305,CARTAGO,LA UNION,CONCEPCION,Concepción        ,12376,7315,7052,263,228,35,5061,616,20,1380,2399,646
152,3,305,30504,CARTAGO,TURRIALBA,SANTA CRUZ,Santa Cruz        ,2438,1230,1200,30,26,4,1208,147,2,274,622,163
153,3,305,30509,CARTAGO,TURRIALBA,SANTA ROSA,Santa Rosa        ,4071,1959,1912,47,42,5,2112,335,7,514,977,279
154,3,305,30505,CARTAGO,TURRIALBA,SANTA TERESITA,Santa Teresita    ,3569,1509,1467,42,38,4,2060,219,5,432,1122,282
155,3,305,30503,CARTAGO,TURRIALBA,PERALTA,Peralta           ,383,176,172,4,3,1,207,16,0,40,111,40
156,3,305,30510,CARTAGO,TURRIALBA,TRES EQUIS,Tres Equis        ,1337,691,683,8,7,1,646,77,0,114,384,71
157,3,301,30111,CARTAGO,CARTAGO,QUEBRADILLA,Quebradilla       ,3874,1995,1906,89,76,13,1879,154,6,446,1007,266
158,3,301,30107,CARTAGO,CARTAGO,CORRALILLO,Corralillo        ,8210,4159,4062,97,85,12,4051,330,3,954,2233,531
159,3,305,30511,CARTAGO,TURRIALBA,LA ISABEL,La Isabel,4610,2261,2179,82,65,17,2349,349,4,659,1090,247
160,3,305,30501,CARTAGO,TURRIALBA,TURRIALBA,Turrialba         ,20963,10374,10090,284,244,40,10589,1912,37,3058,4384,1198
161,3,305,30506,CARTAGO,TURRIALBA,PAVONES,Pavones           ,3304,1558,1504,54,49,5,1746,190,0,375,912,269
162,3,308,30802,CARTAGO,EL GUARCO,SAN ISIDRO,San Isidro        ,7222,3798,3657,141,128,13,3424,307,6,799,1783,529
163,5,509,50906,GUANACASTE,NANDAYURE,BEJUCO,Bejuco            ,2256,1009,971,38,34,4,1247,104,4,223,672,244
164,5,510,51001,GUANACASTE,LA CRUZ,LA CRUZ,La Cruz           ,6431,3050,2924,126,100,26,3381,258,17,1061,1413,632
165,5,510,51003,GUANACASTE,LA CRUZ,GARITA,La Garita         ,1116,449,434,15,15,0,667,63,2,150,344,108
166,5,510,51002,GUANACASTE,LA CRUZ,SANTA CECILIA,Santa Cecilia     ,4134,1830,1772,58,49,9,2304,85,7,495,1241,476
167,5,510,51004,GUANACASTE,LA CRUZ,SANTA ELENA,Santa Elena       ,1425,615,598,17,16,1,810,48,1,177,496,88
168,5,501,50103,GUANACASTE,LIBERIA,MAYORGA,Mayorga           ,1123,431,409,22,21,1,692,32,1,133,298,228
169,5,501,50104,GUANACASTE,LIBERIA,NACASCOLO,Nacascolo         ,1571,786,755,31,30,1,785,71,4,181,325,204
170,5,501,50102,GUANACASTE,LIBERIA,CAÑAS DULCES,Cañas Dulces      ,2392,1162,1120,42,36,6,1230,141,3,289,564,233
171,5,501,50105,GUANACASTE,LIBERIA,CURUBANDE,Curubandé         ,1820,941,921,20,19,1,879,72,5,183,371,248
172,5,504,50403,GUANACASTE,BAGACES,MOGOTE,Mogote            ,2427,1134,1103,31,27,4,1293,58,6,306,655,268
173,5,504,50404,GUANACASTE,BAGACES,RIO NARANJO,Río Naranjo       ,781,316,303,13,9,4,465,45,3,106,249,62
174,5,504,50402,GUANACASTE,BAGACES,FORTUNA,La Fortuna        ,2060,921,903,18,13,5,1139,64,2,291,557,225
175,5,506,50602,GUANACASTE,CAÑAS,PALMIRA,Palmira           ,711,308,301,7,5,2,403,41,2,69,228,63
176,5,505,50503,GUANACASTE,CARRILLO,SARDINAL,Sardinal          ,10919,5441,5176,265,242,23,5478,695,35,1158,2141,1449
177,5,505,50502,GUANACASTE,CARRILLO,PALMIRA,Palmira           ,3911,1904,1799,105,99,6,2007,178,9,456,904,460
178,5,504,50401,GUANACASTE,BAGACES,BAGACES,Bagaces           ,8769,4071,3886,185,152,33,4698,519,26,1069,2246,838
179,5,506,50601,GUANACASTE,CAÑAS,CAÑAS,Cañas            ,15046,7578,7341,237,208,29,7468,740,42,1748,3553,1385
180,5,508,50804,GUANACASTE,TILARAN,SANTA ROSA,Santa Rosa        ,1469,673,646,27,25,2,796,113,7,154,447,75
181,5,503,50304,GUANACASTE,SANTA CRUZ,TEMPATE,Tempate           ,4207,2065,1973,92,67,25,2142,152,32,340,1032,586
182,5,503,50302,GUANACASTE,SANTA CRUZ,BOLSON,Bolsón            ,1264,457,440,17,17,0,807,77,0,146,365,219
183,5,502,50203,GUANACASTE,NICOYA,SAN ANTONIO,San Antonio       ,5286,1769,1701,68,58,10,3517,441,6,660,1627,783
184,5,503,50301,GUANACASTE,SANTA CRUZ,SANTA CRUZ,Santa Cruz        ,16287,7841,7548,293,262,31,8446,1317,48,2282,3210,1589
185,5,503,50305,GUANACASTE,SANTA CRUZ,CARTAGENA,Cartagena         ,2940,1231,1181,50,48,2,1709,207,8,415,621,458
186,5,505,50504,GUANACASTE,CARRILLO,BELEN,Belén            ,6406,2816,2660,156,141,15,3590,410,3,718,1668,791
187,5,501,50101,GUANACASTE,LIBERIA,LIBERIA,Liberia           ,38674,20408,19374,1034,904,130,18266,2178,138,5409,6379,4162
188,5,505,50501,GUANACASTE,CARRILLO,FILADELFIA,Filadelfia        ,5963,2485,2297,188,155,33,3478,506,16,899,1415,642
189,5,508,50801,GUANACASTE,TILARAN,TILARAN,Tilarán           ,6454,3261,3165,96,82,14,3193,409,22,803,1564,395
190,5,508,50805,GUANACASTE,TILARAN,LIBANO,Líbano            ,673,297,290,7,5,2,376,23,0,61,224,68
191,5,506,50605,GUANACASTE,CAÑAS,POROZAL,Porozal           ,491,229,223,6,6,0,262,23,0,40,160,39
192,5,506,50604,GUANACASTE,CAÑAS,BEBEDERO,Bebedero          ,1526,737,706,31,25,6,789,75,2,162,415,135
193,5,506,50603,GUANACASTE,CAÑAS,SAN MIGUEL,San Miguel        ,1252,627,603,24,21,3,625,51,1,90,337,146
194,5,503,50309,GUANACASTE,SANTA CRUZ,TAMARINDO,Tamarindo         ,4764,2748,2619,129,97,32,2016,213,57,355,782,609
195,5,503,50308,GUANACASTE,SANTA CRUZ,CABO VELAS,Cabo Velas        ,2570,1388,1307,81,65,16,1182,134,8,262,399,379
196,5,503,50303,GUANACASTE,SANTA CRUZ,VEINTISIETE DE ABRIL,Veintisiete de Abril,5297,2166,2037,129,106,23,3131,271,17,503,1377,963
197,5,503,50306,GUANACASTE,SANTA CRUZ,CUAJINIQUIL,Cuajiniquil       ,1307,557,545,12,12,0,750,56,3,96,287,308
198,5,502,50206,GUANACASTE,NICOYA,NOSARA,Nosara            ,3516,1913,1856,57,49,8,1603,77,10,298,756,462
199,5,502,50207,GUANACASTE,NICOYA,BELEN DE NOSARITA,Belén de Nosarita ,1971,615,596,19,15,4,1356,45,3,221,494,593
200,5,502,50201,GUANACASTE,NICOYA,NICOYA,Nicoya            ,18916,8805,8449,356,284,72,10111,1326,72,2511,3853,2349
201,5,503,50307,GUANACASTE,SANTA CRUZ,DIRIA,Diriá            ,3024,1338,1262,76,74,2,1686,268,1,392,606,419
202,5,502,50205,GUANACASTE,NICOYA,SAMARA,Sámara            ,2612,1300,1266,34,33,1,1312,113,12,300,614,273
203,5,509,50901,GUANACASTE,NANDAYURE,CARMONA,Carmona           ,1909,897,875,22,19,3,1012,158,4,270,441,139
204,5,511,51101,GUANACASTE,HOJANCHA,HOJANCHA,Hojancha          ,3259,1467,1442,25,21,4,1792,185,7,471,812,317
205,5,511,51102,GUANACASTE,HOJANCHA,MONTE ROMO,Monte Romo,513,221,209,12,11,1,292,38,0,78,145,31
206,5,509,50903,GUANACASTE,NANDAYURE,ZAPOTAL,Zapotal           ,926,389,373,16,13,3,537,48,2,126,296,65
207,5,511,51103,GUANACASTE,HOJANCHA,PUERTO CARRILLO,Puerto Carrillo   ,1201,505,490,15,14,1,696,63,1,180,306,146
208,5,509,50905,GUANACASTE,NANDAYURE,PORVENIR,Porvenir          ,592,255,248,7,7,0,337,50,0,84,163,40
209,5,509,50904,GUANACASTE,NANDAYURE,SAN PABLO,San Pablo         ,1618,610,568,42,38,4,1008,109,1,227,438,233
210,5,511,51104,GUANACASTE,HOJANCHA,HUACAS,Huacas            ,548,223,222,1,1,0,325,32,1,86,165,41
211,5,502,50204,GUANACASTE,NICOYA,QUEBRADA HONDA,Quebrada Honda    ,1978,720,689,31,27,4,1258,109,0,291,624,234
212,5,509,50902,GUANACASTE,NANDAYURE,SANTA RITA,Santa Rita        ,1083,376,344,32,29,3,707,70,0,169,324,144
213,5,502,50202,GUANACASTE,NICOYA,MANSION,Mansión           ,4346,1765,1718,47,39,8,2581,251,24,569,1178,559
214,5,507,50701,GUANACASTE,ABANGARES,JUNTAS,Las Juntas        ,7046,3312,3164,148,135,13,3734,477,12,818,1801,626
215,5,507,50704,GUANACASTE,ABANGARES,COLORADO,Colorado          ,3343,1495,1397,98,87,11,1848,175,2,418,1000,253
216,5,507,50702,GUANACASTE,ABANGARES,SIERRA,Sierra            ,1742,938,908,30,27,3,804,52,9,184,453,106
217,5,508,50803,GUANACASTE,TILARAN,TRONADORA,Tronadora         ,1359,614,603,11,11,0,745,83,3,154,369,136
218,5,508,50806,GUANACASTE,TILARAN,TIERRAS MORENAS,Tierras Morenas   ,1021,440,424,16,11,5,581,65,3,82,327,104
219,5,508,50807,GUANACASTE,TILARAN,ARENAL,Arenal            ,1702,840,816,24,17,7,862,127,14,164,441,116
220,5,508,50802,GUANACASTE,TILARAN,QUEBRADA GRANDE,Quebrada Grande   ,2027,1024,1001,23,22,1,1003,80,4,198,539,182
221,5,507,50703,GUANACASTE,ABANGARES,SAN JUAN,San Juan          ,1192,534,508,26,25,1,658,52,1,94,351,160
222,4,408,40803,HEREDIA,FLORES,LLORENTE,Llorente          ,6725,3920,3800,120,88,32,2805,346,18,822,1278,341
223,4,401,40104,HEREDIA,HEREDIA,ULLOA,Ulloa            ,22374,13777,13335,442,392,50,8597,961,44,2645,3469,1478
224,4,401,40102,HEREDIA,HEREDIA,MERCEDES,Mercedes          ,20531,12315,11961,354,302,52,8216,1682,73,2451,2902,1108
225,4,403,40306,HEREDIA,SANTO DOMINGO,SANTA ROSA,Santa Rosa        ,5693,3339,3215,124,106,18,2354,356,22,537,997,442
226,4,403,40301,HEREDIA,SANTO DOMINGO,SANTO DOMINGO,Santo Domingo     ,4030,2176,2108,68,58,10,1854,545,23,449,603,234
227,4,403,40302,HEREDIA,SANTO DOMINGO,SAN VICENTE,San Vicente       ,5216,2860,2788,72,64,8,2356,421,15,702,742,476
228,4,403,40305,HEREDIA,SANTO DOMINGO,SANTO TOMAS,Santo Tomás       ,5013,2888,2810,78,55,23,2125,420,21,595,742,347
229,4,403,40307,HEREDIA,SANTO DOMINGO,TURES,Tures            ,2657,1516,1466,50,41,9,1141,184,3,290,506,158
230,4,403,40304,HEREDIA,SANTO DOMINGO,PARACITO,Paracito          ,1719,1015,988,27,24,3,704,89,1,184,330,100
231,4,404,40403,HEREDIA,SANTA BARBARA,SAN JUAN,San Juan          ,5946,3448,3353,95,77,18,2498,296,19,643,1196,344
232,4,408,40802,HEREDIA,FLORES,BARRANTES,Barrantes         ,3232,1879,1850,29,24,5,1353,255,14,384,508,192
233,4,408,40801,HEREDIA,FLORES,SAN JOAQUIN,San Joaquín       ,5717,3438,3340,98,89,9,2279,446,35,613,944,241
234,4,404,40402,HEREDIA,SANTA BARBARA,SAN PEDRO,San Pedro         ,4174,2355,2250,105,76,29,1819,195,13,437,921,253
235,4,404,40404,HEREDIA,SANTA BARBARA,JESUS,Jesús            ,7209,4048,3953,95,81,14,3161,331,28,775,1468,559
236,4,404,40405,HEREDIA,SANTA BARBARA,SANTO DOMINGO,Santo Domingo,2162,1197,1176,21,19,2,965,92,12,231,507,123
237,4,404,40406,HEREDIA,SANTA BARBARA,PURABA,Purabá            ,3523,1924,1878,46,43,3,1599,149,5,438,770,237
238,4,401,40103,HEREDIA,HEREDIA,SAN FRANCISCO,San Francisco     ,37385,22057,21300,757,647,110,15328,1876,106,4714,5988,2644
239,4,402,40202,HEREDIA,BARVA,SAN PEDRO,San Pedro         ,7590,4168,4051,117,102,15,3422,318,21,949,1565,569
240,4,402,40204,HEREDIA,BARVA,SAN ROQUE,San Roque         ,3599,2202,2160,42,40,2,1397,229,5,428,578,157
241,4,401,40101,HEREDIA,HEREDIA,HEREDIA,Heredia           ,16071,8592,8335,257,219,38,7479,1898,97,2099,2173,1212
242,4,405,40503,HEREDIA,SAN RAFAEL,SANTIAGO,Santiago          ,6471,3905,3775,130,107,23,2566,361,27,857,1028,293
243,4,402,40201,HEREDIA,BARVA,BARVA,Barva            ,4063,2283,2251,32,29,3,1780,421,9,508,545,297
244,4,405,40501,HEREDIA,SAN RAFAEL,SAN RAFAEL,San Rafael        ,7649,4347,4221,126,113,13,3302,554,19,876,1405,448
245,4,405,40502,HEREDIA,SAN RAFAEL,SAN JOSECITO,San Josecito      ,8996,5230,5041,189,173,16,3766,515,17,990,1565,679
246,4,405,40504,HEREDIA,SAN RAFAEL,ANGELES,Ángeles           ,7858,4500,4389,111,95,16,3358,481,27,908,1451,491
247,4,402,40205,HEREDIA,BARVA,SANTA LUCIA,Santa Lucía       ,5859,3500,3421,79,72,7,2359,407,9,722,867,354
248,4,402,40203,HEREDIA,BARVA,SAN PABLO,San Pablo         ,6409,3657,3562,95,77,18,2752,306,6,810,1266,364
249,4,402,40206,HEREDIA,BARVA,SAN JOSE DE LA MONTAÑA,San José de la Montaña,4055,2433,2367,66,57,9,1622,216,6,433,677,290
250,4,406,40604,HEREDIA,SAN ISIDRO,SAN FRANCISCO,San Francisco     ,3468,1909,1861,48,41,7,1559,200,10,436,668,245
251,4,405,40505,HEREDIA,SAN RAFAEL,CONCEPCIÓN,Concepción        ,4555,2590,2517,73,65,8,1965,268,13,565,763,356
252,4,406,40602,HEREDIA,SAN ISIDRO,SAN JOSE,San José          ,5750,3420,3347,73,63,10,2330,420,31,683,945,251
253,4,406,40603,HEREDIA,SAN ISIDRO,CONCEPCIÓN,Concepción        ,2074,1224,1201,23,22,1,850,137,2,240,370,101
254,4,406,40601,HEREDIA,SAN ISIDRO,SAN ISIDRO,San Isidro        ,4880,2933,2867,66,57,9,1947,262,20,600,840,225
255,4,403,40308,HEREDIA,SANTO DOMINGO,PARA,Pará            ,2674,1575,1535,40,36,4,1099,190,9,305,509,86
256,4,403,40303,HEREDIA,SANTO DOMINGO,SAN MIGUEL,San Miguel        ,5100,2956,2883,73,59,14,2144,274,9,602,905,354
257,4,407,40703,HEREDIA,BELEN,ASUNCION,La Asunción       ,4661,2786,2703,83,68,15,1875,360,33,565,707,210
258,4,407,40701,HEREDIA,BELEN,SAN ANTONIO,San Antonio       ,8002,4653,4556,97,90,7,3349,452,28,837,1460,572
259,4,407,40702,HEREDIA,BELEN,LA RIBERA,La Ribera         ,4806,2780,2714,66,61,5,2026,340,13,451,851,371
260,4,410,41005,HEREDIA,SARAPIQUI,CUREÑA,Cureña            ,654,322,311,11,6,5,332,10,1,74,170,77
261,4,410,41002,HEREDIA,SARAPIQUI,VIRGEN,La Virgen         ,7396,3643,3495,148,126,22,3753,298,21,688,2053,693
262,4,410,41001,HEREDIA,SARAPIQUI,PUERTO VIEJO,Puerto Viejo      ,13420,7166,6892,274,249,25,6254,265,29,1452,3283,1225
263,4,410,41004,HEREDIA,SARAPIQUI,LLANURAS DEL GASPAR,Llanuras del Gaspar,792,430,424,6,4,2,362,12,1,84,201,64
264,4,410,41003,HEREDIA,SARAPIQUI,HORQUETAS,Las Horquetas     ,17185,8351,8117,234,207,27,8834,841,35,2063,4547,1348
265,4,401,40105,HEREDIA,HEREDIA,VARA BLANCA,Varablanca,527,325,322,3,3,0,202,20,0,46,104,32
266,4,409,40901,HEREDIA,SAN PABLO,SAN PABLO,San Pablo         ,15318,8947,8706,241,212,29,6371,1038,51,2034,2173,1075
267,4,409,40902,HEREDIA,SAN PABLO,RINCON DE SABANILLA,Rincón de Sabanilla,6605,3883,3761,122,109,13,2722,530,33,809,928,422
268,4,404,40401,HEREDIA,SANTA BARBARA,SANTA BARBARA,Santa Bárbara     ,4681,2654,2589,65,59,6,2027,407,19,548,903,150
269,7,705,70501,LIMON,MATINA,MATINA,Matina            ,6180,3202,3031,171,157,14,2978,191,23,668,1423,673
270,7,704,70404,LIMON,TALAMANCA,TELIRE,Telire,3899,1943,1905,38,35,3,1956,95,5,495,874,487
271,7,704,70401,LIMON,TALAMANCA,BRATSI,Bratsi            ,4756,2265,2223,42,32,10,2491,140,3,611,1218,519
272,7,704,70403,LIMON,TALAMANCA,CAHUITA,Cahuita           ,5686,2976,2835,141,129,12,2710,216,57,559,1114,764
273,7,702,70206,LIMON,POCOCI,COLORADO,Colorado          ,2743,1500,1469,31,30,1,1243,51,3,235,655,299
274,7,706,70604,LIMON,GUACIMO,RIO JIMENEZ,Río Jiménez       ,6077,2953,2842,111,99,12,3124,232,12,585,1725,570
275,7,701,70101,LIMON,LIMON,LIMON,Limón,43765,22250,21070,1180,1010,170,21515,2612,150,5441,7830,5482
276,7,701,70103,LIMON,LIMON,RIO BLANCO,Río Blanco        ,5616,2587,2435,152,108,44,3029,188,3,674,1505,659
277,7,701,70104,LIMON,LIMON,MATAMA,Matama            ,4836,2331,2224,107,82,25,2505,221,4,507,1242,531
278,7,703,70303,LIMON,SIQUIRRES,FLORIDA,Florida           ,1617,790,762,28,22,6,827,89,1,208,425,104
279,7,703,70301,LIMON,SIQUIRRES,SIQUIRRES,Siquirres         ,22430,11481,11049,432,371,61,10949,1172,41,2398,5328,2010
280,7,703,70302,LIMON,SIQUIRRES,PACUARITO,Pacuarito         ,6077,3120,3015,105,98,7,2957,255,12,619,1487,584
281,7,705,70502,LIMON,MATINA,BATAN,Batán            ,11339,5749,5468,281,259,22,5590,592,41,1244,2725,988
282,7,705,70503,LIMON,MATINA,CARRANDI,Carrandi          ,8221,4411,4278,133,114,19,3810,278,20,768,1797,947
283,7,703,70306,LIMON,SIQUIRRES,ALEGRIA,Alegría        ,3971,1984,1918,66,50,16,1987,177,4,471,1133,202
284,7,703,70304,LIMON,SIQUIRRES,GERMANIA,Germania          ,1832,902,881,21,15,6,930,116,1,232,506,75
285,7,703,70305,LIMON,SIQUIRRES,CAIRO,El Cairo          ,4247,2044,1962,82,74,8,2203,207,1,461,1105,429
286,7,706,70601,LIMON,GUACIMO,GUACIMO,Guácimo           ,12919,6735,6474,261,227,34,6184,586,72,1307,3175,1044
287,7,706,70602,LIMON,GUACIMO,MERCEDES,Mercedes          ,1337,551,527,24,23,1,786,71,2,384,250,79
288,7,706,70603,LIMON,GUACIMO,POCORA,Pocora            ,4631,2310,2204,106,95,11,2321,285,10,490,1117,419
289,7,702,70202,LIMON,POCOCI,JIMENEZ,Jiménez           ,7393,3953,3775,178,163,15,3440,302,19,769,1782,568
290,7,702,70201,LIMON,POCOCI,GUAPILES,Guápiles          ,26647,14604,14145,459,405,54,12043,1410,101,3221,5645,1666
291,7,702,70205,LIMON,POCOCI,CARIARI,Cariari           ,24123,11709,11045,664,578,86,12414,1346,27,2562,6445,2034
292,7,702,70203,LIMON,POCOCI,RITA,Rita             ,17063,8136,7688,448,413,35,8927,799,35,1518,4937,1638
293,7,702,70204,LIMON,POCOCI,ROXANA,Roxana            ,11761,6005,5727,278,247,31,5756,435,12,1221,3090,998
294,7,706,70605,LIMON,GUACIMO,DUACARI,Duacarí           ,4095,2084,1991,93,80,13,2011,166,9,481,1086,269
295,7,701,70102,LIMON,LIMON,VALLE LA ESTRELLA,Valle La Estrella ,11338,4863,4680,183,152,31,6475,327,7,1334,3137,1670
296,7,704,70402,LIMON,TALAMANCA,SIXAOLA,Sixaola           ,5558,2843,2770,73,61,12,2715,128,5,746,1381,455
297,6,611,61101,PUNTARENAS,GARABITO,JACO,Jacó             ,8280,5176,4970,206,167,39,3104,194,72,648,1554,636
298,6,611,61102,PUNTARENAS,GARABITO,TARCOLES,Tárcoles          ,3964,2201,2139,62,49,13,1763,129,18,358,874,384
299,6,601,60111,PUNTARENAS,PUNTARENAS,COBANO,Cóbano            ,5442,3070,2984,86,78,8,2372,158,52,486,1120,556
300,6,601,60105,PUNTARENAS,PUNTARENAS,PAQUERA,Paquera           ,4875,2142,2083,59,54,5,2733,195,15,533,1270,720
301,6,601,60102,PUNTARENAS,PUNTARENAS,PITAHAYA,Pitahaya          ,1515,711,691,20,19,1,804,91,1,122,450,140
302,6,601,60115,PUNTARENAS,PUNTARENAS,EL ROBLE,El Roble          ,11589,5762,5527,235,212,23,5827,802,40,1563,2285,1137
303,6,601,60112,PUNTARENAS,PUNTARENAS,CHACARITA,Chacarita         ,12681,6050,5813,237,204,33,6631,916,26,1527,2950,1212
304,6,601,60104,PUNTARENAS,PUNTARENAS,LEPANTO,Lepanto           ,7170,2948,2837,111,106,5,4222,510,21,960,2049,682
305,6,601,60101,PUNTARENAS,PUNTARENAS,PUNTARENAS,Puntarenas        ,6801,3622,3499,123,103,20,3179,757,31,803,1033,555
306,6,601,60106,PUNTARENAS,PUNTARENAS,MANZANILLO,Manzanillo        ,1965,863,842,21,18,3,1102,84,0,260,571,187
307,6,601,60113,PUNTARENAS,PUNTARENAS,CHIRA,Chira        ,1119,498,489,9,7,2,621,66,2,188,300,65
308,6,601,60109,PUNTARENAS,PUNTARENAS,MONTE  VERDE,Monte Verde       ,3042,1821,1768,53,47,6,1221,95,24,390,537,175
309,6,601,60114,PUNTARENAS,PUNTARENAS,ACAPULCO,Acapulco          ,993,463,454,9,8,1,530,53,4,103,254,116
310,6,601,60103,PUNTARENAS,PUNTARENAS,CHOMES,Chomes            ,3940,1710,1636,74,67,7,2230,215,15,436,1098,466
311,6,604,60402,PUNTARENAS,MONTES DE ORO,UNION,La Unión          ,968,405,399,6,5,1,563,54,1,106,280,122
312,6,604,60401,PUNTARENAS,MONTES DE ORO,MIRAMAR,Miramar           ,6433,3146,3083,63,57,6,3287,543,8,741,1427,568
313,6,604,60403,PUNTARENAS,MONTES DE ORO,SAN ISIDRO,San Isidro        ,2494,1164,1106,58,55,3,1330,167,1,267,652,243
314,6,601,60107,PUNTARENAS,PUNTARENAS,GUACIMAL,Guacimal          ,698,337,333,4,4,0,361,36,0,61,226,38
315,6,602,60203,PUNTARENAS,ESPARZA,MACACONA,Macacona          ,3497,1820,1777,43,35,8,1677,149,6,460,828,234
316,6,602,60201,PUNTARENAS,ESPARZA,ESPIRITU SANTO,Espíritu Santo    ,11873,5853,5620,233,205,28,6020,934,29,1594,2766,697
317,6,602,60202,PUNTARENAS,ESPARZA,SAN JUAN GRANDE,San Juan Grande   ,4433,2133,2048,85,78,7,2300,248,5,490,1149,408
318,6,602,60204,PUNTARENAS,ESPARZA,SAN RAFAEL,San Rafael        ,1020,506,494,12,11,1,514,67,0,118,262,67
319,6,601,60108,PUNTARENAS,PUNTARENAS,BARRANCA,Barranca          ,21866,10370,9897,473,424,49,11496,1211,25,2917,5129,2214
320,6,602,60205,PUNTARENAS,ESPARZA,SAN JERONIMO,San Jerónimo      ,590,285,282,3,3,0,305,36,1,69,157,42
321,6,601,60116,PUNTARENAS,PUNTARENAS,ARANCIBIA,Arancibia         ,514,200,199,1,1,0,314,31,0,74,154,55
322,6,606,60603,PUNTARENAS,AGUIRRE,NARANJITO,Naranjito         ,2687,1382,1323,59,46,13,1305,144,5,268,633,255
323,6,606,60602,PUNTARENAS,AGUIRRE,SAVEGRE,Savegre           ,2440,1226,1199,27,22,5,1214,117,13,231,682,171
324,6,603,60309,PUNTARENAS,BUENOS AIRES,BRUNKA,Brunka            ,2159,909,849,60,53,7,1250,91,3,233,767,156
325,6,605,60504,PUNTARENAS,OSA,BAHIA BALLENA,Bahía Ballena     ,2379,1396,1362,34,31,3,983,102,17,171,504,189
326,6,603,60302,PUNTARENAS,BUENOS AIRES,VOLCAN,Volcán            ,2706,1171,1119,52,48,4,1535,102,3,289,849,292
327,6,608,60802,PUNTARENAS,COTO BRUS,SABALITO,Sabalito          ,7534,3447,3392,55,48,7,4087,327,6,865,2337,552
328,6,608,60805,PUNTARENAS,COTO BRUS,PITTIER,Pittier           ,1885,841,827,14,10,4,1044,32,0,195,654,163
329,6,603,60305,PUNTARENAS,BUENOS AIRES,PILAS,Pilas            ,1124,493,492,1,0,1,631,11,0,102,376,142
330,6,603,60306,PUNTARENAS,BUENOS AIRES,COLINAS,Colinas      ,983,520,519,1,1,0,463,13,5,83,304,58
331,6,605,60501,PUNTARENAS,OSA,PUERTO CORTES,Puerto Cortés     ,5834,2771,2693,78,73,5,3063,412,11,622,1330,688
332,6,603,60304,PUNTARENAS,BUENOS AIRES,BORUCA,Boruca            ,2118,869,842,27,26,1,1249,105,0,345,618,181
333,6,603,60301,PUNTARENAS,BUENOS AIRES,BUENOS AIRES,Buenos Aires      ,14300,6881,6665,216,179,37,7419,455,31,1936,3784,1213
334,6,605,60502,PUNTARENAS,OSA,PALMAR,Palmar            ,7146,3485,3367,118,107,11,3661,437,12,784,1820,608
335,6,605,60505,PUNTARENAS,OSA,PIEDRAS BLANCAS,Piedras Blancas   ,3030,1314,1268,46,38,8,1716,139,6,321,928,322
336,6,603,60303,PUNTARENAS,BUENOS AIRES,POTRERO GRANDE,Potrero Grande    ,3882,1527,1439,88,80,8,2355,161,3,528,1203,460
337,6,603,60307,PUNTARENAS,BUENOS AIRES,CHANGUENA,Chánguena         ,1695,750,736,14,11,3,945,25,0,145,623,152
338,6,603,60308,PUNTARENAS,BUENOS AIRES,BIOLLEY,Biolley           ,1691,750,741,9,7,2,941,36,0,201,499,205
339,6,608,60801,PUNTARENAS,COTO BRUS,SAN VITO,San Vito          ,10550,4818,4708,110,91,19,5732,593,16,1349,2887,887
340,6,608,60804,PUNTARENAS,COTO BRUS,LIMONCITO,Limoncito         ,2288,798,784,14,12,2,1490,108,1,277,811,293
341,6,607,60702,PUNTARENAS,GOLFITO,PUERTO JIMENEZ,Puerto Jiménez    ,6258,3088,2962,126,116,10,3170,203,14,644,1536,773
342,6,607,60701,PUNTARENAS,GOLFITO,GOLFITO,Golfito           ,8303,4300,4094,206,187,19,4003,470,11,979,1846,697
343,6,607,60703,PUNTARENAS,GOLFITO,GUAYCARA,Guaycará          ,9305,4404,4274,130,112,18,4901,425,32,1110,2372,962
344,6,608,60803,PUNTARENAS,COTO BRUS,AGUA BUENA,Aguabuena         ,4491,2054,1978,76,54,22,2437,204,9,510,1345,369
345,6,607,60704,PUNTARENAS,GOLFITO,PAVON,Pavón ,4179,1788,1749,39,32,7,2391,167,24,468,1243,489
346,6,610,61001,PUNTARENAS,CORREDORES,CORRERDOR,Corredor          ,12377,6439,6276,163,147,16,5938,659,17,1487,2645,1130
347,6,610,61003,PUNTARENAS,CORREDORES,CANOAS,Canoas            ,7973,3918,3827,91,71,20,4055,239,28,875,2134,779
348,6,610,61002,PUNTARENAS,CORREDORES,LA CUESTA,La Cuesta         ,2795,1476,1449,27,22,5,1319,99,2,285,683,250
349,6,610,61004,PUNTARENAS,CORREDORES,LAUREL,Laurel            ,6441,2949,2902,47,34,13,3492,213,3,566,2046,664
350,6,605,60503,PUNTARENAS,OSA,SIERPE,Sierpe            ,3069,1451,1416,35,31,4,1618,138,7,247,885,341
351,6,609,60901,PUNTARENAS,PARRITA,PARRITA,Parrita           ,11857,5980,5784,196,178,18,5877,629,30,1093,2942,1183
352,6,606,60601,PUNTARENAS,AGUIRRE,QUEPOS,Quepos            ,14677,8278,7926,352,314,38,6399,572,45,1456,2903,1423
353,1,116,11603,SAN JOSE,TURRUBARES,SAN JUAN DE MATA,San Juan de Mata  ,885,445,412,33,33,0,440,40,7,104,238,51
354,1,116,11605,SAN JOSE,TURRUBARES,CARARA,Carara,1304,643,626,17,12,5,661,38,4,132,371,116
355,1,116,11604,SAN JOSE,TURRUBARES,SAN LUIS,San Luis          ,397,173,167,6,5,1,224,28,0,43,125,28
356,1,107,10703,SAN JOSE,MORA,TABARCIA,Tabarcia          ,3561,1713,1642,71,61,10,1848,191,8,426,892,331
357,1,104,10405,SAN JOSE,PURISCAL,SAN RAFAEL,San Rafael        ,1409,649,631,18,18,0,760,118,1,167,355,119
358,1,104,10401,SAN JOSE,PURISCAL,SANTIAGO,Santiago          ,9122,4935,4801,134,112,22,4187,611,18,1324,1744,490
359,1,112,11202,SAN JOSE,ACOSTA,GUAITIL,Guaitil           ,1846,870,850,20,13,7,976,90,1,176,542,167
360,1,104,10406,SAN JOSE,PURISCAL,CANDELARITA,Candelarita       ,1112,481,472,9,8,1,631,75,2,138,319,97
361,1,104,10409,SAN JOSE,PURISCAL,CHIRES,Chires            ,2289,1008,957,51,33,18,1281,139,0,280,641,221
362,1,112,11203,SAN JOSE,ACOSTA,PALMICHAL,Palmichal         ,3421,1755,1717,38,27,11,1666,127,3,447,936,153
363,1,112,11201,SAN JOSE,ACOSTA,SAN IGNACIO,San Ignacio       ,6862,3565,3489,76,61,15,3297,424,6,972,1467,428
364,1,112,11204,SAN JOSE,ACOSTA,CANGREJAL,Cangrejal         ,1400,603,592,11,4,7,797,90,0,150,465,92
365,1,112,11205,SAN JOSE,ACOSTA,SABANILLAS,Sabanillas        ,1741,775,764,11,9,2,966,125,1,158,537,145
366,1,106,10603,SAN JOSE,ASERRI,VUELTA DE JORCO,Vuelta de Jorco   ,4956,2451,2378,73,52,21,2505,213,2,663,1322,305
367,1,106,10604,SAN JOSE,ASERRI,SAN GABRIEL,San Gabriel       ,4521,2254,2203,51,38,13,2267,197,3,494,1044,529
368,1,106,10602,SAN JOSE,ASERRI,TARBACA,Tarbaca     ,1096,586,561,25,19,6,510,54,0,119,260,77
369,1,103,10309,SAN JOSE,DESAMPARADOS,ROSARIO,Rosario           ,2281,1252,1227,25,22,3,1029,79,0,240,627,83
370,1,120,12001,SAN JOSE,LEON CORTES,SAN PABLO,San Pablo         ,3123,1489,1446,43,35,8,1634,111,3,440,816,264
371,1,120,12004,SAN JOSE,LEON CORTES,SAN ISIDRO,San Isidro        ,1123,500,480,20,19,1,623,24,0,150,382,67
372,1,120,12003,SAN JOSE,LEON CORTES,LLANO BONITO,Llano Bonito      ,1552,687,670,17,15,2,865,39,4,174,546,102
373,1,106,10605,SAN JOSE,ASERRI,LEGUA,Legua           ,1063,480,467,13,10,3,583,66,0,113,355,49
374,1,106,10606,SAN JOSE,ASERRI,MONTERREY,Monterrey         ,362,170,165,5,4,1,192,13,1,42,105,31
375,1,103,10308,SAN JOSE,DESAMPARADOS,SAN CRISTOBAL,San Cristóbal     ,2839,1472,1438,34,29,5,1367,108,1,295,810,153
376,1,103,10306,SAN JOSE,DESAMPARADOS,FRAILES,Frailes           ,2844,1443,1383,60,48,12,1401,101,3,289,809,199
377,1,120,12006,SAN JOSE,LEON CORTES,SAN ANTONIO,San Antonio       ,841,408,402,6,6,0,433,41,9,102,244,37
378,1,120,12002,SAN JOSE,LEON CORTES,SAN ANDRES,San Andrés        ,1174,541,526,15,7,8,633,44,3,115,359,112
379,1,120,12005,SAN JOSE,LEON CORTES,SANTA CRUZ,Santa Cruz        ,1271,660,657,3,3,0,611,28,4,138,385,56
380,1,117,11701,SAN JOSE,DOTA,SANTA MARIA,Santa María       ,3461,1716,1671,45,40,5,1745,203,7,489,890,156
381,1,105,10501,SAN JOSE,TARRAZU,SAN MARCOS,San Marcos        ,7427,3813,3692,121,115,6,3614,313,5,932,1901,463
382,1,117,11703,SAN JOSE,DOTA,COPEY,Copey            ,1317,721,718,3,2,1,596,25,0,141,385,45
383,1,116,11602,SAN JOSE,TURRUBARES,SAN PEDRO,San Pedro         ,520,254,246,8,8,0,266,52,1,46,140,27
384,1,116,11601,SAN JOSE,TURRUBARES,SAN PABLO,San Pablo         ,1027,476,463,13,9,4,551,107,1,157,259,27
385,1,104,10402,SAN JOSE,PURISCAL,MERCEDES SUR,Mercedes Sur      ,4562,2294,2232,62,53,9,2268,257,3,623,1045,340
386,1,104,10403,SAN JOSE,PURISCAL,BARBACOAS,Barbacoas         ,2838,1401,1357,44,31,13,1437,184,2,362,687,202
387,1,104,10404,SAN JOSE,PURISCAL,GRIFO ALTO,Grifo Alto        ,922,411,398,13,10,3,511,46,3,93,269,100
388,1,104,10408,SAN JOSE,PURISCAL,SAN ANTONIO,San Antonio       ,2978,1611,1544,67,61,6,1367,155,2,369,640,201
389,1,107,10702,SAN JOSE,MORA,GUAYABO,Guayabo           ,3381,1812,1766,46,43,3,1569,114,6,389,772,288
390,1,110,11003,SAN JOSE,ALAJUELITA,SAN ANTONIO,San Antonio       ,3423,1945,1880,65,62,3,1478,135,2,337,679,325
391,1,104,10407,SAN JOSE,PURISCAL,DESAMPARADITOS,Desamparaditos    ,542,267,264,3,2,1,275,17,0,45,62,151
392,1,107,10704,SAN JOSE,MORA,PIEDRAS NEGRAS,Piedras Negras    ,288,115,111,4,4,0,173,10,1,37,83,42
393,1,109,10902,SAN JOSE,SANTA ANA,SALITRAL,Salitral          ,3171,1945,1900,45,39,6,1226,69,14,294,626,223
394,1,102,10201,SAN JOSE,ESCAZU,ESCAZU,Escazú            ,9580,5624,5431,193,163,30,3956,661,52,1012,1448,783
395,1,102,10202,SAN JOSE,ESCAZU,SAN ANTONIO,San Antonio       ,17544,10627,10307,320,288,32,6917,858,25,1856,2922,1256
396,1,101,10110,SAN JOSE,SAN JOSE,HATILLO,Hatillo           ,39555,21647,20655,992,877,115,17908,3661,75,4514,6219,3439
397,1,110,11005,SAN JOSE,ALAJUELITA,SAN FELIPE,San Felipe        ,22391,12254,11793,461,403,58,10137,597,18,2660,4161,2701
398,1,110,11002,SAN JOSE,ALAJUELITA,SAN JOSECITO,San Josecito      ,7779,4434,4324,110,96,14,3345,401,9,915,1556,464
399,1,106,10601,SAN JOSE,ASERRI,ASERRI,Aserrí            ,21291,12045,11632,413,368,45,9246,1040,44,2389,4293,1480
400,1,103,10303,SAN JOSE,DESAMPARADOS,SAN JUAN DE DIOS,San Juan de Dios  ,14462,8198,7905,293,267,26,6264,732,15,1531,2902,1084
401,1,106,10607,SAN JOSE,ASERRI,SALITRILLOS,Salitrillos       ,10107,5646,5458,188,159,29,4461,576,19,1020,2210,636
402,1,103,10302,SAN JOSE,DESAMPARADOS,SAN MIGUEL,San Miguel        ,24071,13752,13218,534,476,58,10319,1280,33,3062,4587,1357
403,1,103,10304,SAN JOSE,DESAMPARADOS,SAN RAFAEL ARRIBA,San Rafael Arriba ,11832,6638,6386,252,226,26,5194,583,36,1445,2087,1043
404,1,103,10312,SAN JOSE,DESAMPARADOS,GRAVILIAS,Gravilias         ,12360,7131,6874,257,226,31,5229,1316,35,1366,1799,713
405,1,103,10311,SAN JOSE,DESAMAPARADOS,SAN RAFAEL ABAJO,San Rafael Abajo  ,17822,10638,10266,372,321,51,7184,862,81,2057,3255,929
406,1,103,10301,SAN JOSE,DESAMPARADOS,DESAMPARADOS,Desamparados      ,26951,15973,15203,770,714,56,10978,2003,100,2753,4409,1713
407,1,101,10106,SAN JOSE,SAN JOSE,SAN FRANCISCO DE DOS RIOS,San Francisco de Dos Ríos,16895,9702,9475,227,174,53,7193,1680,67,2012,2009,1425
408,1,110,11004,SAN JOSE,ALAJUELITA,CONCEPCION,Concepción        ,13829,7736,7356,380,340,40,6093,654,15,1533,2776,1115
409,1,110,11001,SAN JOSE,ALAJUELITA,ALAJUELITA,Alajuelita,9282,5395,5209,186,124,62,3887,517,34,983,1617,736
410,1,101,10111,SAN JOSE,SAN JOSE,SAN SEBASTIAN,San Sebastián     ,31633,18196,17445,751,659,92,13437,2281,66,3576,5411,2103
411,1,118,11801,SAN JOSE,CURRIDABAT,CURRIDABAT,Curridabat        ,24057,13935,13540,395,343,52,10122,2012,112,3119,3134,1745
412,1,101,10105,SAN JOSE,SAN JOSE,ZAPOTE,Zapote          ,15545,8655,8402,253,219,34,6890,1748,65,1825,2245,1007
413,1,103,10305,SAN JOSE,DESAMPARADOS,SAN ANTONIO,San Antonio       ,7928,4658,4524,134,108,26,3270,703,21,896,1196,454
414,1,103,10310,SAN JOSE,DESAMPARADOS,DAMAS,Damas            ,10201,5968,5809,159,141,18,4233,614,11,1226,1770,612
415,1,103,10313,SAN JOSE,DESAMPARADOS,LOS GUIDO,Los Guido,16884,8752,8192,560,499,61,8132,503,10,2073,4025,1521
416,1,103,10307,SAN JOSE,DESAMPARADOS,PATARRA,Patarrá          ,8817,4904,4718,186,153,33,3913,370,25,1105,1877,536
417,1,118,11803,SAN JOSE,CURRIDABAT,SANCHEZ,Sánchez           ,4367,2809,2765,44,37,7,1558,262,39,621,376,260
418,1,118,11804,SAN JOSE,CURRIDABAT,TIRRASES,Tirrases          ,11827,6815,6552,263,236,27,5012,594,24,1251,2182,961
419,1,109,10906,SAN JOSE,SANTA ANA,BRASIL,Brasil            ,1975,1219,1203,16,14,2,756,82,3,231,379,61
420,1,109,10905,SAN JOSE,SANTA ANA, PIEDADES,Piedades          ,6434,3781,3695,86,74,12,2653,312,58,645,1088,550
421,1,109,10904,SAN JOSE,SANTA ANA,URUCA,Uruca,5548,3311,3225,86,81,5,2237,297,38,624,893,385
422,1,109,10901,SAN JOSE,SANTA ANA,SANTA ANA,Santa Ana         ,9075,5696,5583,113,105,8,3379,546,58,908,1233,634
423,1,109,10903,SAN JOSE,SANTA ANA,POZOS,Pozos   ,11893,7582,7390,192,174,18,4311,475,107,1352,1629,748
424,1,101,10109,SAN JOSE,SAN JOSE,PAVAS,Pavas            ,54510,30700,29400,1300,1028,272,23810,3441,150,5951,9169,5099
425,1,102,10203,SAN JOSE,ESCAZU,SAN RAFAEL,San Rafael        ,17673,10945,10632,313,267,46,6728,1128,216,2029,2045,1310
426,1,101,10108,SAN JOSE,SAN JOSE,MATA REDONDA,Mata Redonda      ,7077,3823,3692,131,111,20,3254,860,61,964,890,479
427,1,113,11304,SAN JOSE,TIBAS,LEON XIII,León XIII     ,9881,4963,4712,251,219,32,4918,549,13,1121,1924,1311
428,1,101,10102,SAN JOSE,SAN JOSE,MERCED,Merced         ,9655,5720,5503,217,180,37,3935,817,44,1008,1363,703
429,1,101,10103,SAN JOSE,SAN JOSE,HOSPITAL,Hospital          ,15096,8518,8141,377,348,29,6578,1125,32,1593,2058,1770
430,1,101,10104,SAN JOSE,SAN JOSE,CATEDRAL,Catedral          ,10742,6339,6126,213,191,22,4403,1304,57,1048,1323,671
431,1,101,10101,SAN JOSE,SAN JOSE,CARMEN,Carmen           ,2431,1369,1332,37,33,4,1062,345,46,232,232,207
432,1,113,11302,SAN JOSE,TIBAS,CINCO ESQUINAS,Cinco Esquinas    ,4478,2608,2482,126,107,19,1870,330,22,415,782,321
433,1,108,10802,SAN JOSE,GOICOECHEA,SAN FRANCISCO,San Francisco     ,1684,929,888,41,35,6,755,172,5,141,266,171
434,1,108,10803,SAN JOSE,GOICOECHEA,CALLE BLANCOS,Calle Blancos     ,15370,9086,8745,341,280,61,6284,1301,57,1723,2203,1000
435,1,113,11303,SAN JOSE,TIBAS,ANSELMO LLORENTE,Anselmo Llorente  ,8475,4738,4609,129,108,21,3737,902,18,1091,1125,601
436,1,108,10801,SAN JOSE,GOICOECHEA,GUADALUPE,Guadalupe         ,17467,9606,9301,305,252,53,7861,1974,96,1802,2712,1277
437,1,115,11503,SAN JOSE,MONTES DE OCA,MERCEDES,Mercedes,4056,2343,2297,46,39,7,1713,305,31,793,383,201
438,1,115,11501,SAN JOSE,MONTES DE OCA,SAN PEDRO,San Pedro         ,20841,11967,11657,310,271,39,8874,1884,103,3388,2068,1431
439,1,108,10804,SAN JOSE,GOICOECHEA,MATA DE PLATANO,Mata de Plátano   ,13808,8441,8204,237,213,24,5367,860,50,1639,2172,646
440,1,115,11504,SAN JOSE,MONTES DE OCA,SAN RAFAEL,San Rafael        ,7590,4623,4430,193,158,35,2967,391,16,958,1032,570
441,1,118,11802,SAN JOSE,CURRIDABAT,GRANADILLA,Granadilla        ,11665,6994,6778,216,192,24,4671,525,73,1575,1665,833
442,1,115,11502,SAN JOSE,MONTES DE OCA,SABANILLA,Sabanilla         ,9074,5492,5333,159,126,33,3582,733,41,1346,1063,399
443,1,101,10107,SAN JOSE,SAN JOSE,URUCA,Uruca            ,22717,13410,12869,541,486,55,9307,1019,87,2626,3614,1961
444,1,113,11305,SAN JOSE,TIBAS,COLIMA,Colima            ,11014,6588,6355,233,204,29,4426,795,22,1328,1747,534
445,1,113,11301,SAN JOSE,TIBAS,SAN JUAN,San Juan          ,18346,10348,10055,293,247,46,7998,2150,78,2076,2622,1072
446,1,114,11401,SAN JOSE,MORAVIA,SAN VICENTE,San Vicente       ,25728,14940,14478,462,409,53,10788,2422,164,3096,3531,1575
447,1,108,10805,SAN JOSE,GOICOECHEA,IPIS,Ipís             ,20253,11627,11221,406,340,66,8626,1232,37,2366,3579,1412
448,1,108,10807,SAN JOSE,GOICOECHEA,PURRAL,Purral            ,20052,10671,10156,515,466,49,9381,740,20,2679,3574,2368
449,1,108,10806,SAN JOSE,GOICOECHEA,RANCHO REDONDO,Rancho Redondo    ,1903,1059,1007,52,45,7,844,104,0,173,429,138
450,1,111,11101,SAN JOSE,VAZQUEZ DE CORONADO,SAN ISIDRO,San Isidro        ,13338,7948,7745,203,176,27,5390,843,27,1739,2076,705
451,1,111,11102,SAN JOSE,VAZQUEZ DE CORONADO,SAN RAFAEL,San Rafael        ,5553,3148,3052,96,84,12,2405,316,17,678,1069,325
452,1,111,11105,SAN JOSE,VAZQUEZ DE CORONADO,CASCAJAL,Cascajal          ,5057,2797,2681,116,93,23,2260,232,20,570,1151,287
453,1,114,11402,SAN JOSE,MORAVIA,SAN JERONIMO,San Jerónimo      ,4669,2648,2572,76,64,12,2021,185,16,520,949,351
454,1,114,11403,SAN JOSE,MORAVIA,TRINIDAD,La Trinidad       ,15047,9077,8774,303,267,36,5970,574,13,1776,2479,1128
455,1,111,11104,SAN JOSE,VAZQUEZ DE CORONADO,PATALILLO,Patalillo         ,16175,9601,9344,257,213,44,6574,816,32,2077,2430,1219
456,1,107,10701,SAN JOSE,MORA,COLON,Colón            ,12642,7412,7174,238,214,24,5230,716,40,1416,2263,795
457,1,107,10705,SAN JOSE,MORA,PICAGRES,Picagres          ,542,220,215,5,2,3,322,28,0,51,165,78
458,1,111,11103,SAN JOSE,VAZQUEZ DE CORONADO,DULCE NOMBRE DE JESUS,Dulce Nombre de Jesús,7574,4360,4184,176,154,22,3214,386,20,933,1373,502
459,1,117,11702,SAN JOSE,DOTA,JARDIN,Jardín            ,386,208,208,0,0,0,178,16,1,40,106,15
460,1,105,10503,SAN JOSE,TARRAZU,SAN CARLOS,San Carlos        ,1257,619,612,7,7,0,638,22,0,91,481,44
461,1,105,10502,SAN JOSE,TARRAZU,SAN LORENZO,San Lorenzo       ,3116,1605,1565,40,38,2,1511,80,2,302,961,166
462,1,119,11911,SAN JOSE,PEREZ ZELEDON,PARAMO,Páramo            ,3201,1514,1481,33,22,11,1687,94,1,367,955,270
463,1,119,11910,SAN JOSE,PEREZ ZELEDON,RIO NUEVO,Río Nuevo         ,2166,998,989,9,6,3,1168,63,2,250,667,186
464,1,119,11904,SAN JOSE,PEREZ ZELEDON,RIVAS,Rivas            ,4852,2300,2237,63,50,13,2552,169,6,592,1404,381
465,1,119,11909,SAN JOSE,PEREZ ZELEDON,BARU,Barú             ,1755,838,814,24,23,1,917,65,0,120,554,178
466,1,119,11901,SAN JOSE,PEREZ ZELEDON,SAN ISIDRO DE EL GENERAL,San Isidro de El General,33748,17303,16645,658,559,99,16445,1904,90,4762,7445,2244
467,1,119,11903,SAN JOSE,PEREZ ZELEDON,DANIEL FLORES,Daniel Flores     ,24565,12106,11664,442,375,67,12459,1022,73,3230,6150,1984
468,1,119,11908,SAN JOSE,PEREZ ZELEDON,CAJON,Cajón  ,6007,2487,2365,122,104,18,3520,234,13,783,1979,511
469,1,119,11902,SAN JOSE,PEREZ ZELEDON,GENERAL,El General        ,4651,2115,2032,83,65,18,2536,250,1,561,1231,493
470,1,119,11905,SAN JOSE,PEREZ ZELEDON,SAN PEDRO,San Pedro         ,6317,2665,2575,90,72,18,3652,206,13,725,2140,568
471,1,119,11907,SAN JOSE,PEREZ ZELEDON,PEJIBAYE,Pejibaye          ,5749,2533,2502,31,24,7,3216,157,3,647,1924,485
472,1,119,11906,SAN JOSE,PEREZ ZELEDON,PLATANARES,Platanares        ,5175,2295,2247,48,38,10,2880,154,10,741,1713,262
